......##.#...#......#............#.....#
...#..#....#..#.....#...#.....#.#.......
#.#......#...................#.#......#.
.#...#....###.#.#..#.#.....#.#...#.#..##
.#..#..#....#.......#.....##......#....#
....#..#...##.....#..#...##...####.....#
.........#..............#........#..#...
.............######..#.........#..#...#.
...#.....##.#..........#..#.....##......
..#....#...#..##......##........#.....#.
..........#..#..##....#....#...#.##..#..
..#.........#....#.....#......#.....##..
..#..#..#.#......#...##...#..#....#.....
..#............#..##..#..#..#...##......
..............#...#.#....#..##.#..###...
....#..#..#.#.#.###.##.......#...#...#..
...#.......................###...##.#.#.
#.....#.##..#.....#....#................
...##........#.................#.#..#.#.
.......#........................##......
.###....#....#.#.#.............#.#..#.#.
........#...........#.....#......#.#....
.........#..##....#...#.....#...#.......
......#.....#..#..........##...#.....#..
....#.#..#...#.#.##.#...#...#..#.#......
....#......#..#..............###......#.
.#........##......#...#......#.##..#.#..
...#.....#...............#......#....##.
................#.#....##............##.
..#......#....#..............#....#.....
#.#..###..#.......#...................#.
#..#.#....#...##.#........#.#....#..#..#
#..#.............#......#.....#.........
....#.#.........#......###.#.....#..##.#
..#..#..........#.#...#........#........
......##..###......#.#.........#.......#
....#...#.##......#.##.....#......#.....
.......#..#......##..#.#......#.....#...
....#.#.........#........#....##.......#
...#..#.....#...#.##...#.#.#.#.#...##.#.
\robot 0 0
\robot 0 1