##########
#........#
#........#
#.########
#.########
#.########
#...######
#...######
#...######
#........#
##########
\robot 1 1
\robot 2 1
\robot 3 4