...#...#......####..
#....#.#..#.......##
.##.#..........#.#..
...#....#...#.#.#.#.
.#.#.....##.#.......
......#..#..#.#.#.#.
.......#...#........
.##....#.#.#..#...#.
....#...#.......#.#.
....##.....#...#.#..
#.#...#..###.###.#.#
#..#.....#...##.....
..#..##.#..#..#.####
#..#..#.#..#....#.#.
..##..#.##.#.....#..
##........###...##..
#...##...##..#......
#.........#..#.#....
..#......#...#####.#
#.#..#.#.....##...#.
\robot 1 1
\robot 3 0
\robot 9 0