#.........
.#........
....##....
........#.
.##.#....#
..#.#.....
.#..#.....
..........
.#..#...#.
...#..##..
\robot 7 1
\robot 6 4
\robot 7 8
